ğŸ“¦ RECURSOS BÃSICOS
Fibra ğŸŒ¾ - Material bÃ¡sico para artesanato
Pedra ğŸª¨ - Pedras comuns para construÃ§Ã£o
Pedras Soltas ğŸª¨ - Pedras pequenas
Gravetos ğŸªµ - Galhos pequenos
Ãgua Fresca ğŸ’§ - Ãgua potÃ¡vel
Bambu ğŸ‹ - Material flexÃ­vel para construÃ§Ã£o
Madeira ğŸŒ³ - Material versÃ¡til para construÃ§Ã£o
Argila ğŸ§± - Material moldÃ¡vel para cerÃ¢mica
Ferro Fundido âš™ï¸ - Metal processado
Couro ğŸ¦« - Material para equipamentos
Carne ğŸ¥© - Alimento bÃ¡sico
Ossos ğŸ¦´ - Subproduto de animais
Pelo ğŸ§¶ - Fibra animal
Barbante ğŸ§µ - CordÃ£o bÃ¡sico
ğŸŒ¾ FIBRAS ESPECIALIZADAS
Linho - Fibra de alta qualidade
AlgodÃ£o â˜ï¸ - Fibra macia
Juta - Fibra resistente
Sisal - Fibra duradoura
CÃ¢nhamo - Fibra para cordas
ğŸŒ³ MADEIRAS ESPECIAIS
Madeira de Carvalho - Madeira nobre e resistente
Madeira de Pinho - Madeira comum
Madeira de Cedro - Madeira aromÃ¡tica
Madeira de Eucalipto - Madeira de crescimento rÃ¡pido
Madeira de Mogno - Madeira exÃ³tica e valiosa
ğŸ’ MINERAIS E GEMAS
Pedra CalcÃ¡ria - Pedra para construÃ§Ã£o
Pedra Granito - Pedra dura
Pedra ArdÃ³sia - Pedra laminada
Pedra MÃ¡rmore - Pedra decorativa
Quartzo - Cristal bÃ¡sico
Ametista - Gema roxa rara
TopÃ¡zio - Gema amarela
Esmeralda - Gema verde valiosa
Rubi - Gema vermelha
Diamante - Gema mais valiosa
âš’ï¸ METAIS E MINERAIS
Mineral de Ferro - MinÃ©rio bruto
Mineral de Cobre - MinÃ©rio avermelhado
Mineral de Estanho - MinÃ©rio para ligas
Mineral de Chumbo - MinÃ©rio pesado
Mineral de Zinco - MinÃ©rio para galvanizaÃ§Ã£o
Mineral de Prata - Metal precioso
Mineral de Ouro - Metal mais valioso
Mineral de Platina - Metal raro
CarvÃ£o - CombustÃ­vel fÃ³ssil
CarvÃ£o Vegetal - CombustÃ­vel orgÃ¢nico
Enxofre - Mineral quÃ­mico
Salitre - Mineral para pÃ³lvora
ğŸ¾ ANIMAIS TERRESTRES PEQUENOS
Coelho ğŸ° - Animal pequeno comum
Lebre - Parente do coelho
Raposa - Animal astuto com pelo valioso
Esquilo - Animal pequeno arborÃ­cola
Castor - Animal aquÃ¡tico
Lontra - Animal semi-aquÃ¡tico
ğŸ¦Œ ANIMAIS TERRESTRES MÃ‰DIOS
Veado ğŸ¦Œ - Animal gracioso da floresta
Cervo - Parente maior do veado
Javali ğŸ— - Animal feroz e perigoso
Porco Selvagem - Variante do javali
Cabra da Montanha - Animal montanhÃªs
Ovelha Selvagem - Animal de lÃ£
ğŸ» ANIMAIS TERRESTRES GRANDES
Urso - Animal perigoso e valioso
Alce - Maior cervÃ­deo
Rena - CervÃ­deo do frio
BisÃ£o - Bovino selvagem grande
Boi Selvagem - Bovino primitivo
ğŸ¦… AVES
Pato - Ave aquÃ¡tica
Ganso - Ave maior que o pato
Cisne - Ave elegante
Galinha d'Angola - Ave terrestre
Perdiz - Ave de caÃ§a
Codorna - Ave pequena
FaisÃ£o - Ave colorida
Pombo - Ave urbana
Rolinha - Pombo pequeno
Coruja - Ave noturna
FalcÃ£o - Ave de rapina
Ãguia - Maior ave de rapina
ğŸŸ PEIXES DE ÃGUA DOCE
Peixe Pequeno ğŸŸ - Peixe bÃ¡sico
Peixe Grande ğŸ  - Peixe mÃ©dio
SalmÃ£o ğŸ£ - Peixe premium
Truta - Peixe saboroso
Carpa - Peixe comum
Bagre - Peixe de fundo
LÃºcio - Peixe predador
Perca - Peixe listrado
Dourado - Peixe dourado
Pintado - Peixe manchado
Surubim - Peixe grande
TraÃ­ra - Peixe agressivo
Tambaqui - Peixe da AmazÃ´nia
Pirarucu - Peixe gigante
ğŸŒŠ PEIXES MARINHOS
Atum - Peixe oceÃ¢nico grande
Sardinha - Peixe pequeno em cardume
Anchova - Peixe salgado
Bacalhau - Peixe do AtlÃ¢ntico Norte
Linguado - Peixe chato
Robalo - Peixe esportivo
Dourada - Peixe dourado marinho
Pregado - Peixe chato grande
Mero - Peixe grande de profundidade
Garoupa - Peixe de recife
ğŸ¦ FRUTOS DO MAR
CamarÃ£o - CrustÃ¡ceo pequeno
Lagosta - CrustÃ¡ceo de luxo
Caranguejo - CrustÃ¡ceo terrestre/marinho
Siri - Caranguejo pequeno
Ostra - Molusco bivalve
MexilhÃ£o - Molusco filtrador
Vieira - Molusco com concha decorativa
Lula - Molusco cefalÃ³pode
Polvo - Molusco inteligente
ğŸ„ PLANTAS E VEGETAIS SELVAGENS
Cogumelos ğŸ„ - Fungos comestÃ­veis bÃ¡sicos
Cogumelos Shiitake - Cogumelos premium
Cogumelos Ostra - Cogumelos cultivados
Frutas Silvestres ğŸ« - Mix de frutas selvagens
Amoras - Frutas roxas
Framboesas - Frutas vermelhas
Mirtilos - Frutas azuis
Morangos Selvagens - Frutas doces
MaÃ§Ã£s Selvagens - Frutas Ã¡cidas
Nozes - Frutos secos
AvelÃ£s - Nozes pequenas
Castanhas - Frutos do outono
PinhÃµes - Sementes de pinheiro
RaÃ­zes ComestÃ­veis - TubÃ©rculos selvagens
Ervas Medicinais - Plantas curativas
Folhas de ChÃ¡ - Plantas para infusÃ£o
Flores ComestÃ­veis - Flores para culinÃ¡ri